1111111111111111111111111
100000000010C0C0C10000001
1000E00000101000010111101
10000000001C1000C100001P1
1000000000101111111110111
1000000000100000000000001
1000C00000101011010C00001
1000000001101000010000001
1000000001001111111111011
11101101110000C0010000001
1C00000000000000010C00001
1111111111111111111111111
